0,1,2,3,4,2,3,4,2,3,4,5
7,8,8,8,8,8,8,8,8,8,8,19
14,22,22,22,22,22,22,22,22,23,24,26
7,22,23,24,25,18,18,18,25,25,25,12
14,22,23,24,25,25,25,25,16,17,18,19
14,15,23,16,17,17,17,17,16,17,18,19
14,15,16,17,24,24,24,17,16,17,18,19
14,15,16,17,23,23,24,24,16,17,18,19
14,15,16,17,23,24,16,17,17,17,18,19
14,15,16,17,16,16,16,17,16,16,17,19
21,22,23,24,23,23,16,17,17,17,24,26
28,29,29,29,29,30,29,29,30,31,32,33
